1111111111111111
10P0000000000001
11111110000000C1
11100C0000000011
1111100000000C11
10E00C0000001111
1111111111111111
