111111111111
10P000000001
1111111000C1
11100C000011
111110000C11
10E00C001111
111111111111
